N|N|N|N|N|N|N|N|N|N|N|N|N|N|N|N|N|N|N|N|N|N|N|N|N|N|N|N
N|N|N|N|N|N|N|N|N|N|N|N|N|N|N|N|N|N|N|N|N|N|N|N|N|N|N|N
N|N|N|N|N|N|N|N|N|N|N|N|N|N|N|N|N|N|N|N|N|N|N|N|N|N|N|N
N|N|N|Y|Y|Y|Y|Y|Y|Y|Y|Y|Y|Y|Y|Y|Y|Y|Y|Y|Y|Y|Y|Y|Y|N|N|N
N|N|N|Y|N|N|N|N|N|N|N|N|N|N|N|Y|N|N|N|N|N|N|N|N|Y|N|N|N
N|N|N|Y|N|N|N|N|N|N|N|N|N|N|N|Y|N|N|N|N|N|N|N|N|Y|N|N|N
N|N|N|Y|N|N|Y|Y|Y|N|Y|Y|Y|N|Y|Y|Y|N|Y|Y|Y|N|N|N|Y|N|N|N
N|N|N|Y|N|N|Y|Y|Y|Y|Y|Y|Y|N|Y|Y|Y|N|Y|Y|Y|N|N|N|Y|N|N|N
N|N|N|Y|N|N|Y|Y|Y|N|Y|Y|Y|N|Y|Y|Y|N|Y|Y|Y|N|N|N|Y|N|N|N
N|N|N|Y|N|N|N|N|N|N|N|Y|N|N|N|Y|N|N|N|Y|N|N|N|N|Y|N|N|N
N|N|N|Y|N|N|Y|Y|Y|N|N|Y|N|N|N|Y|N|N|N|Y|N|Y|Y|N|Y|N|N|N
N|N|N|Y|Y|Y|Y|Y|Y|Y|Y|Y|Y|Y|Y|Y|Y|Y|Y|Y|Y|Y|Y|N|Y|N|N|N
N|N|N|Y|N|N|Y|Y|Y|N|N|Y|N|N|N|N|N|N|N|Y|N|Y|Y|N|Y|N|N|N
N|N|N|Y|N|N|N|Y|N|N|N|Y|N|N|N|N|N|N|N|Y|N|N|N|N|Y|N|N|N
N|N|N|Y|N|N|Y|Y|Y|N|Y|Y|Y|N|Y|Y|Y|N|Y|Y|Y|N|N|N|Y|N|N|N
N|N|N|Y|N|N|Y|Y|Y|N|Y|Y|Y|Y|Y|Y|Y|N|Y|Y|Y|N|N|N|Y|N|N|N
N|N|N|Y|N|N|Y|Y|Y|N|Y|Y|Y|N|Y|Y|Y|N|Y|Y|Y|N|N|N|Y|N|N|N
N|N|N|Y|N|N|N|Y|N|N|N|N|N|N|N|Y|N|N|N|N|N|N|N|N|Y|N|N|N
N|N|N|Y|N|N|Y|Y|Y|N|N|N|N|Y|Y|Y|Y|Y|N|N|Y|Y|Y|N|Y|N|N|N
N|N|N|Y|N|N|Y|Y|Y|N|N|N|N|Y|Y|Y|Y|Y|N|N|Y|Y|Y|N|Y|N|N|N
N|N|N|Y|N|N|N|N|N|N|N|N|N|N|N|N|N|N|N|N|N|Y|N|N|Y|N|N|N
N|N|N|Y|Y|Y|Y|Y|Y|Y|Y|Y|Y|Y|Y|Y|Y|Y|Y|Y|Y|Y|Y|Y|Y|N|N|N
N|N|N|N|N|N|Y|N|N|N|N|N|N|N|Y|N|N|N|N|N|N|Y|N|N|N|N|N|N
N|N|N|N|N|N|Y|N|N|N|N|N|N|N|Y|N|N|N|N|N|N|Y|N|N|N|N|N|N
N|N|N|N|Y|Y|Y|Y|Y|N|N|N|Y|Y|Y|Y|Y|N|N|Y|Y|Y|Y|Y|N|N|N|N
N|N|N|N|Y|Y|Y|Y|Y|N|N|N|Y|Y|Y|Y|Y|N|N|Y|Y|Y|Y|Y|N|N|N|N
N|N|N|N|Y|Y|Y|Y|Y|N|N|N|Y|Y|Y|Y|Y|N|N|Y|Y|Y|Y|Y|N|N|N|N
N|N|N|N|N|N|N|N|N|N|N|N|N|N|N|N|N|N|N|N|N|N|N|N|N|N|N|N
{PW=(20,16); D=(27, 15)}