N|N|N|N|N|N|N|N|N|N|N|N|N|N|N|N|N|N|N|N|N|N|N|N|N|N|N|N
N|N|Y|Y|Y|Y|Y|N|N|N|N|N|Y|Y|Y|N|N|N|N|N|N|N|N|N|N|N|N|N
N|N|Y|Y|Y|Y|Y|Y|Y|Y|N|N|Y|Y|Y|N|N|N|Y|Y|Y|Y|N|N|N|N|N|N
N|N|Y|Y|Y|Y|Y|N|N|Y|N|N|Y|Y|Y|N|N|N|N|N|N|Y|N|N|N|N|N|N
N|N|N|N|Y|N|N|N|N|Y|N|N|N|Y|N|N|N|N|N|N|N|Y|N|Y|Y|Y|Y|N
N|N|N|N|Y|N|N|N|N|Y|Y|Y|Y|Y|Y|Y|Y|Y|Y|N|N|Y|Y|Y|Y|Y|Y|N
N|N|N|N|Y|N|N|N|N|N|N|N|N|Y|N|N|N|N|Y|N|N|N|N|Y|Y|Y|Y|N
N|N|Y|Y|Y|Y|Y|N|N|N|N|N|N|N|N|N|N|N|Y|N|N|N|N|Y|Y|Y|Y|N
N|N|Y|Y|Y|Y|Y|Y|Y|Y|Y|Y|Y|Y|Y|Y|Y|Y|Y|N|N|N|N|N|N|Y|N|N
N|N|Y|Y|Y|Y|Y|N|N|N|N|N|N|N|N|N|N|N|N|N|N|N|N|N|N|Y|N|N
N|N|N|N|Y|N|N|N|N|N|N|N|N|N|Y|Y|Y|Y|Y|Y|Y|Y|N|N|N|Y|N|N
N|N|N|N|Y|N|N|N|N|N|N|N|N|N|Y|Y|Y|Y|Y|Y|Y|Y|N|N|N|Y|N|N
N|N|N|N|Y|N|N|Y|Y|Y|Y|Y|N|N|Y|Y|Y|Y|Y|Y|Y|Y|N|N|N|Y|N|N
N|N|Y|Y|Y|Y|Y|Y|Y|Y|Y|Y|Y|Y|Y|N|N|N|Y|N|N|N|N|N|N|Y|N|N
N|N|N|N|N|N|N|Y|Y|Y|Y|Y|N|N|N|N|N|N|Y|N|N|N|N|N|N|Y|N|N
N|N|N|N|Y|N|N|N|N|Y|N|N|N|N|N|N|Y|Y|Y|Y|Y|N|N|N|N|Y|N|N
N|N|N|N|Y|N|N|N|N|Y|N|N|N|N|N|N|Y|Y|Y|Y|Y|Y|Y|Y|Y|Y|N|N
N|N|N|N|Y|N|N|N|N|Y|Y|Y|Y|Y|N|N|Y|Y|Y|Y|Y|N|N|N|N|Y|N|N
N|N|Y|Y|Y|Y|N|N|N|Y|N|N|N|Y|N|N|N|N|Y|N|N|N|N|N|N|Y|N|N
N|N|Y|N|N|Y|N|N|N|Y|N|N|N|Y|N|N|N|N|Y|N|N|N|N|N|N|Y|N|N
N|N|Y|N|N|Y|N|N|Y|Y|Y|Y|Y|Y|Y|Y|Y|Y|Y|Y|Y|Y|Y|Y|Y|Y|N|N
N|N|Y|N|N|N|N|N|N|N|N|N|N|N|N|N|N|N|Y|N|N|N|N|Y|N|N|N|N
N|N|Y|Y|Y|Y|Y|Y|N|N|Y|Y|Y|Y|Y|Y|Y|Y|Y|Y|Y|Y|N|Y|N|N|N|N
N|N|Y|N|N|Y|Y|Y|N|N|Y|N|N|Y|N|N|N|N|Y|N|N|N|N|Y|N|N|N|N
N|N|Y|N|N|Y|Y|Y|N|N|Y|N|N|Y|N|N|N|N|Y|N|N|Y|Y|Y|Y|Y|N|N
N|N|Y|N|N|Y|Y|Y|Y|Y|Y|N|Y|Y|Y|N|N|N|Y|Y|Y|Y|Y|Y|Y|Y|N|N
N|N|N|N|N|N|N|N|N|N|N|N|Y|Y|Y|N|N|N|N|N|N|N|N|N|N|N|N|N
N|N|N|N|N|N|N|N|N|N|N|N|N|N|N|N|N|N|N|N|N|N|N|N|N|N|N|N
{PC=(3,14); D=(26, 14)}