N|N|N|N|N|N|N|N|N|N|N|N|N|N|N|N|N|N|N|N|N|N|N|N|N|N|N|N
N|Y|Y|Y|N|N|N|N|N|N|N|N|N|N|N|N|N|N|N|N|N|Y|Y|Y|N|N|N|N
N|Y|Y|Y|N|N|N|N|N|N|N|N|Y|Y|Y|N|N|N|N|N|N|Y|Y|Y|N|N|N|N
N|N|Y|N|N|N|N|Y|Y|Y|Y|Y|Y|Y|Y|N|N|N|N|N|N|Y|Y|Y|N|N|N|N
N|N|Y|N|N|N|N|Y|N|N|N|N|Y|Y|Y|N|N|N|N|N|N|N|Y|N|N|N|N|N
N|N|Y|Y|Y|Y|Y|Y|N|N|N|N|N|N|N|N|N|N|N|N|N|N|Y|N|N|N|N|N
N|N|Y|N|N|N|N|N|N|N|N|N|N|N|N|N|N|N|N|N|N|N|Y|N|N|N|N|N
N|N|Y|N|N|N|N|N|N|N|N|N|N|N|N|N|N|N|N|Y|Y|Y|Y|Y|Y|Y|N|N
N|N|Y|N|N|N|N|N|N|N|N|Y|Y|Y|Y|Y|N|N|N|Y|Y|Y|Y|Y|Y|Y|N|N
N|N|Y|Y|Y|Y|Y|Y|N|N|N|Y|Y|Y|Y|Y|N|N|N|Y|Y|Y|Y|Y|Y|Y|N|N
N|N|N|Y|N|N|N|Y|N|N|N|Y|Y|Y|Y|Y|N|N|N|Y|Y|Y|Y|Y|Y|Y|N|N
N|N|N|Y|N|N|N|Y|N|N|N|N|N|Y|N|N|N|N|N|N|N|N|Y|N|N|N|N|N
N|N|Y|Y|Y|N|N|Y|N|N|N|N|N|Y|N|N|N|N|N|N|N|N|Y|N|N|N|N|N
N|N|Y|Y|Y|N|N|Y|N|N|N|N|N|Y|N|N|N|N|N|N|Y|Y|Y|Y|Y|N|N|N
N|N|Y|Y|Y|N|N|Y|N|N|N|N|N|Y|N|N|N|N|N|N|Y|N|N|N|Y|N|N|N
N|N|N|N|N|N|N|Y|Y|Y|Y|Y|Y|Y|Y|Y|Y|Y|Y|Y|Y|N|N|N|Y|N|N|N
N|N|N|N|N|N|N|Y|N|N|N|N|N|N|N|N|N|N|N|N|Y|N|N|N|Y|N|N|N
N|N|N|N|N|N|N|Y|N|N|N|N|N|N|N|N|N|N|N|N|Y|N|N|N|Y|N|N|N
N|N|Y|Y|Y|N|N|Y|N|N|Y|Y|Y|N|N|N|N|N|Y|Y|Y|Y|N|N|Y|N|N|N
N|N|Y|Y|Y|Y|Y|Y|Y|Y|Y|Y|Y|N|N|N|N|N|Y|Y|Y|Y|N|N|Y|N|N|N
N|N|Y|Y|Y|N|N|Y|N|N|Y|Y|Y|N|N|N|N|N|Y|Y|Y|Y|N|N|Y|N|N|N
N|N|N|N|N|N|N|Y|N|N|N|N|N|N|N|N|N|N|N|N|N|N|N|N|Y|N|N|N
N|N|N|N|N|N|N|Y|N|N|N|N|N|N|Y|Y|Y|Y|Y|Y|Y|Y|Y|Y|Y|N|N|N
N|N|N|N|N|N|Y|Y|Y|Y|N|N|N|N|Y|N|N|N|N|N|N|N|N|N|N|N|N|N
N|N|N|N|N|N|Y|Y|Y|Y|N|N|N|N|Y|N|N|N|N|N|N|N|N|N|N|N|N|N
N|N|N|N|N|N|Y|Y|Y|Y|N|N|Y|Y|Y|Y|Y|N|N|N|N|N|N|N|N|N|N|N
N|N|N|N|N|N|N|N|N|N|N|N|Y|Y|Y|Y|Y|N|N|N|N|N|N|N|N|N|N|N
N|N|N|N|N|N|N|N|N|N|N|N|N|N|N|N|N|N|N|N|N|N|N|N|N|N|N|N
{PP=(4,14); D=(27, 15)}